11111111111111111111111111111111111111
10CCC1CCCCCC100000000000000000000000E1
10CCC1CCCCCC10000000000000000000000011
101111CCCCCC00000000000000000000000001
10CCCCCCCCCC10000000000000000000000001
10CCCCCCCCCC10000000000000000000000001
10CCCCCCCCCC10000000000000000000000001
10CCCCCCCCCC10000000000000000000000001
10CCCCCCCCCC10000000000000000000000001
10CCCCCCCCCC10000000000000000000000001
10CCCCCCCCCC100000000000000000P0000001
10CCCCCCCCCC10000000000000000000000001
11111111111111111111111111111111111111
