1111111111111
1P0C0000000C1
1111111111E11
1111111111C11
1111111111111
