111111111
1PCE0C101
0C00C0001
111111111
