1111111111111111111111111111111111111111
1CCCC0C1CCCCCC11CCC11CCC11CCCCCC1CCGCCC1
11C111C1C1111C11C1CCCC1C11C1111C1C111C11
11C111C1C1111C11C111111C11C1111C1C111C11
1CPCCCC1CCCCCC11C111111C11CCCCCC1CCCCCC1
1C1111CCC1111CCCCCC11CCCCCC1111CCC1111C1
1CC11CR11111111C1C1111C1111111111CC11BC1
11CCCCCCCCCC1ECC1CCCCCCCCCCCCCCCCCCCCCC1
1111111111111111111111111111111111111111
