1111111111111111111111111111111111111111
1CCCCEC1CCCCCC11CCC11CCC11CCCCCC1CCGCCC1
11C111C1C1111C11C1CCCC1C11C1111C1C111C11
11C111C1C1111C11C111111C11C1111C1C111C11
1CPCCCC1CCCCCC11C111111C11CCCCCC1CCCCCC1
1C1111CCC1111CCCCCC11CCCCCC1111CCC1111C1
1CC11CC1111111111C1111C1111111111CC11CC1
11CCCCCCCCCC1CCC1CCCCCCCCCCCCCCCCCCCCCC1
1CC1C1CC111C1C1C1C1C1C111C11C1C111C111C1
1C11C1CCCC1C1C1C1C1C1C101C11C1CCC1C101C1
1CC1111C111CCC1CCC1C1C111C1C1CC1C1C111C1
11CCC1CC1CCC1C1C001C1C1C1C1CCCCCC1C1C1C1
11C1C1CC111C1C111C111C1C1C1CCCC111C1C1C1
1CC10CCCCCCC1CCCCCCCCCCCCCCC11CCCCCCCCC1
11C11C1C11C111C111111C11C111111111CC11C1
1CCCCC1CCCCCCCCC1CCCCR11CCCCCCCCCCCCCCC1
1111111111111111111111111111111111111111
