1111111111111111111111111111111111111111
10000E010000C011000110001100000010000001
1101110101111011010000101101111010111011
1101110101111011011111101101111010111011
1000000100000011011111101100000010000001
1011110001111000000110000001111000111101
1001100111111111101111011111111110011001
11P0000000001000100000000000000000000001
1001010011101010101010111011010111011101
1011010000101010101010101011010001010101
1001111011100010001010111010100101011101
110001001000101T001010101010000001010101
1101010011101011101110101010000111010101
1001000000001000000000000000110000000001
1101101011011101111110110111111111001101
1000001000000000100000110000000000000001
1111111111111111111111111111111111111111
